static const cartApplyPromoCode = '/cart_apply_promo_code';
static const cartBuyDone = '/cart_buy_done';
static const cartBuyNow = '/cart_buy_now';
static const cartCartIndex = '/cart_cart_index';
static const goodsCategory = '/goods_category';
static const goodsHome = '/goods_home';
static const goodsProductDetails = '/goods_product_details';
static const goodsProductList = '/goods_product_list';
static const msgMsgIndex = '/msg_msg_index';
static const myLanguage = '/my_language';
static const myMyAddress = '/my_my_address';
static const myMyIndex = '/my_my_index';
static const myOrderDetails = '/my_order_details';
static const myOrderList = '/my_order_list';
static const myProfileEdit = '/my_profile_edit';
static const myTheme = '/my_theme';
static const searchSearchFilter = '/search_search_filter';
static const searchSearchIndex = '/search_search_index';
static const stylesAppbar = '/styles_appbar';
static const stylesAvatar = '/styles_avatar';
static const stylesBottomSheet = '/styles_bottom_sheet';
static const stylesButton = '/styles_button';
static const stylesCard = '/styles_card';
static const stylesCheckbox = '/styles_checkbox';
static const stylesColors = '/styles_colors';
static const stylesDialog = '/styles_dialog';
static const stylesForm = '/styles_form';
static const stylesIcon = '/styles_icon';
static const stylesImage = '/styles_image';
static const stylesInput = '/styles_input';
static const stylesListTile = '/styles_list_tile';
static const stylesPopover = '/styles_popover';
static const stylesRadioGroup = '/styles_radio_group';
static const stylesStylesIndex = '/styles_styles_index';
static const stylesText = '/styles_text';
static const systemLogin = '/system_login';
static const systemMain = '/system_main';
static const systemRegister = '/system_register';
static const systemRegisterPin = '/system_register_pin';
static const systemSplash = '/system_splash';
static const systemUserAgreement = '/system_user_agreement';
static const systemWelcome = '/system_welcome';
